11111111111111
1P000000C00001
100C0000000001
10000000000001
101000000000E1
1C100000C00101
10000000000101
100000000001C1
11111111111111